11111111111111111
100100CCCC000C0C1
100100CCCC000C0C1
100100CCCC000C0C1
100100CCCC000C0C1
100100CCCC00001C1
1000C111100011111
1100C0C1100111111
1P00111C000000E11
11111111111111111
